++++++++++++++++++++++++++++++++++++++++++
+                                        +
+ ++++++++++++++++++++ +++++++++++++++++ +
+ ++++++++++++++++++++ +++++++++++++++++ +
+ ++++++++++++++++++++ +++++++++++++++++ +
+ ++++++++++++++++++++ +++++++++++++++++ +
+                                        +
+ ++++++++++++++++++++ +++++++++++++++++ +
+ ++++++++++++++++++++ +++++++++++++++++ +
+ ++++++++++++++++++++ +++++++++++++++++ +
+                                        +
++++++++++++++++++++++++++++++++++++++++++